PDB	HISTONES_CHAINS	BP_CHAINS	DNA_CHAINS
3mvd	C,G,D,H,A,E,B,F	K,L	I,J
3tu4	C,G,D,H,A,E,B,F	K,L	I,J
4jjn	C,G,D,H,A,E,B,F	K,L	I,J
4kud	C,G,D,H,A,E,B,F	K,L	I,J
4ld9	C,G,D,H,A,E,B,F	K,L	I,J
4r8p	C,G,D,H,A,E,B,F	K,L,M,N	I,J
4zux	C,G,M,Q,D,H,N,R,A,E,K,O,B,F,L,P	X,c,h,m,W,b,g,l,Y,d,i,n,V,a,f,k,U,Z,e,j	I,J,S,T
5kgf	C,G,D,H,A,E,B,F	M,O,K,L	I,J
5mlu	C,G,D,H,A,E,B,F	M	I,J
5o9g	C,G,D,H,A,E,B,F	W,W	I,J
5x0y	C,G,D,H,A,E,B,F	O	I,J
5x0x	C,G,D,H,A,E,B,F	O	I,J
6buz	C,G,D,H,A,E,B,F	N	I,J
6c0w	C,G,D,H,A,E,B,F	K	I,J
6etx	K,O,L,P,I,M,J,N	H,G,R,A,C,E,B,D,F	X,Y
6fml	O,S,P,T,M,Q,N,R	A,B,C,D,E,F,H,I,J,J,G	K,L
5e5a	C,G,D,H,A,E,B,F	K	I,J
5gtc	C,G,D,H,A,E,B,F	K	I,J
5hq2	G,H,A,B	K,M	I,J
